NO ./path_to_the_north_texture
SO ./path_to_the_south_texture
WE ./path_to_the_west_texture
EA ./path_to_the_east_texture
F 220,100,0
C 225,30,0
111111111111
1N01000000101
100000000001
100000000001
100000000001
11000000001
1100000001
1111111111111