NO ./path_to_the_north_texture  asdlfkajsdflkjf
SO ./path_to_the_south_texture
WE ./path_to_the_west_texture    
EA       ./path_to_the_west_texture                    
EA       ./path_to_the_west_texture                    

C 0,        30,251
F 1,0,2               



1111    1111111111111
1111  1       1   11
11111101111       1S1
1111111111     1   1         