NO ./texture/eagle.xpm
SO ./texture/eagle.xpm
WE ./texture/eagle.xpm
EA ./texture/eagle.xpm
C 125,125,125
F 50,50,50

111111111111
1N01000000101
110000000011
1111111111111