SO ./texture/wall.xpm
NO ./texture/eagle.xpm
EA ./texture/wall1.xpm
C 125,125,125
F 50,50,50
WE ./texture/wall2.xpm

111111111111
1E01000000101
110000000001
110000000011
110000000011
110000000011
110000100011
110000000011
110000000011
110000000011
110000000011
110000000011
110000000011
110000000011
110000000011
110000000011
110000000011
110000000011
110000000011
110000000011
110000000011
110000000011
110000000011
110000000011
110000000011
110000000011
110000000011
110000000011
110000000011
110000000011
1111111111111